 #####
 #   #####
 #X# ##  #
##       #
#OO#XX X #
#OO  #####
# P###
####